11111111111111111111111111
1000000P00010000C0000V0001
1000V0000100010C0000000001
10C0V0001111111100V0000001
1V00000100V0V000010000E001
11111111111111111111111111