11111111111111111111111111
1000000P00000000C000010001
1001C01000E0100C0001000001
10000C00001000C000000C0001
10000C00010100000C00010001
11111111111111111111111111