1111111111
1P0C0000C1
1100C000E1
1111111111